DXOOOOOOOOOXOO
OOXOXOOOXOOXOO
OOXOOXXOXOOXOO
OOXXOOOXOXXXXX
OOOOXOXXOXOOOO
OOOOXOOOOOOXOA
