DOOOOOOOOOOOOOX
XXOOOXXXXOOOXXX
XXOOOXXXOOOOOOX
XXOOXOOXOOXOOOX
XXOOOXXXOOXOOOX
OOXOOOOOXXOOXOO
OOXOOOXXOOXXOOX
OOOXOOXXXOOOOOX
OOOXXOXOOOXOXOX
XXOOOOOXXOXOXOO
XOOOOOOXOOOXOOX
XOXOOOOOOXOOOOO
XXOXOOXOOXOOOXX
XXOOXOOXOXOOOOX
XXOOXXOXOOOOOOA
